ar	العربية
bg	bǎlgarski
bs	bosanski
ca	català
cs	česky
da	dansk
de	deutsch
el	ελληνικά
es	español
en	english
fa	پارسی
fr	français
he	עברית
hi	हिंदी
hr	hrvatski
hu	magyar
id	Indonesia
it	italiano
ja	日本語
kn	ಕನ್ನಡ
ko	한국의
lv	latviešu valoda
mr	मराठी
nl	nederlands
pl	polski
pt	português
pt-BR	português brasileiro
ro	român
ru	русский
sk	slovenčina
sr	српски
ta	தமிழ்
th	ไทย
tr	Türk
vi	việt
zh-cn	中国（简体）
zh-tw	中國（繁體）
